11111111111111111111
10111111100000000001
10111111111111111101
10111111111111111101
10111111111111111101
10111111111111111101
10111111101111111101
10111111101111111101
10111111101111111101
10111111101111111101
10000000000000000001
11111111101111111111
11111111101111111111
11111111101111111111
11111111101111111111
11111111101111111111
11111111101111111111
11111111100000000001
11111111111111111111
11111111111111111111
