11111111111111111111
10101010101010101001
10000000000000000001
10111111011111111101
10100010010000000001
11000000000000000001
11111110001111111101
10000000000000000001
10000111111111111101
10000000000000000001
10011111111111111001
10000111111111100001
10000001111110000001
10010000111100000001
10000000011100000001
10000000001000000001
10011000001000011001
10010000000000001001
10010000001000001001
11111111111111111111
