1111111111
8081000001
8081011001
1001010001
1101001001
1101101001
1100100001
1010101088
1000000098
1111111188
