111111111111
100001001001
101111001011
100000001001
100000001101
100000000101
100000000001
101110111101
100100100001
100100101111
100100100001
111111111111
