1111111111
1011000011
1011011011
1001010011
1101001011
1101101011
1100100011
1010101011
1000000011
1111111111
