11111111111111111111
10100000000000000001
10101111111111111101
10101000000000000101
10101011111111110101
10101010000000010101
10101010111111010101
10101010100001010101
10101010101101010101
10101010101101010101
10101010100101010101
10101010111101010101
10101010000001010101
10101011111111010101
10101000000000010101
10101111111111110101
10100000000000000101
10111111111111111101
10000000000000000001
11111111111111111111
